,a,c,b,d,f
a,0,2,2,1,1
c,2,0,1,1,0
b,2,1,0,0,1
d,1,1,0,0,0
f,1,0,1,0,0
